11111111
11011001
10010011
11010101
10000001
11111111
